[7 7]
1
XXXXXXX
XH.R  X
X.XDX.X
X.X.X.X
X.X...O
XXXXXXX
