[7 7]
0
XXXOXXX
XH R  X
X  R  X
X RRR X
X RRR X
XXXXXXX
